                 ###      #       
                ##    #   #
         ###        ###   #
                     #### #
         ###        #######
              #######      
                    ########
            #####      ##   
######                      